11111111111111111111111111111111
1P000000000000000000000000000001
10011110001111100111110011111001
1001CC10000C0C1000C0C1001C0C1001
10000010000000100000010000001001
10000C1000000C100000C100000C1001
10000010000111100011110000001001
10000C1000000C100000C100000C1001
10000010000000100000010000001001
10000C10000C0C1000C0C100000C1001
10000111001111100111110000001001
100000000000000000000000000000E1
11111111111111111111111111111111