11111111111111
1P000000000001
100000001000C1
10000000111111
10000000000001
11111100000001
1C000100000001
100000000000E1
11111111111111